pwd - показать текущее местоположение

cd - change directory
  cd ~
  cd
  cd ..
  cd /
  cd foldername
  cd /folder1/folder2
  cd "folder with spaces in name"
  cd Folder\ with \space
ls - list directory contents
  ls -l
  ls -a  
  ls -la
  ls -lh
  ls -laR
touch - change timestamp. Но часто используется для создания файлов
id - print real and effective user and group IDs
mkdir - make directory
rm - remove files or directories
  rm -r - recursively
  rm -f - force
rmdir - remove empty directories
cp - copy 
mv - move
cmp of diff - compare files
ps - processes
  ps -aux
  ps -auxf
kill - stop process
  kill 0 - kill all except shell
  kill -9 PID - process name
netstat - network
  netstat -tulpn
  ss -talpn
route - network
ip - network
  ip addr - get current network settings
  ifconfig - get current network settings
df - disk space usage
cat - concatenate
expr - arithmetic operations
chmod - change mode
chown - change owner
echo - print message
  echo $? - errorcode
head - show first 10 lines
clear - clear screen
tail - show last 10 lines
grep - print lines that match patterns
find - find files
awk - pattern scanning and processing language
tr - translate or delete characterstr 
sed - stream editor for filtering and transforming text
sort - sort
  sort -r - reverse sort
uniq - show only uniq strings
wc - counter
w(ho) - who is connected
vi - editor
env - show environment variables
apt-get - install software
=============================
| pipes (konveyer)
>
>>
command > out 2>error
command > out 2>&1
command &> filename
